angelfish|angelfish
antelope|antelope
ape|apes
baboon|baboons
bald eagle|bald eagles
bat|bats
bee|bees
bird|birds
black bear|black bears
bluebird|bluebirds
buffalo|buffalos
camel|camels
capybara|capybaras
cardinal|cardinals
caribou|caribou
cat|cats
caterpillar|caterpillars
chameleon|chameleons
cockatoo|cockatoos
cow|cows
crab|crabs
crane|cranes
cuckoo|cuckoos
dachshund|dachshunds
dalmatian|dalmatians
deer|deer
dog|dogs
dolphin|dolphins
dove|doves
dragonfly|dragonflies
eagle|eagles
earthworm|earthworms
eel|eels
egret|egrets
elephant|elephants
emu|emu
falcon|falcons
ferret|ferrets
fish|fish
flamingo|flamingos
fox|foxes
frog|frogs
gazelle|gazelles
gecko|geckos
gerbil|gerbils
giraffe|giraffes
gnu|gnus
goat|goats
goldfish|goldfishes
goose|geese
gorilla|gorillas
grasshopper|grasshoppers
greyhound|greyhounds
grizzly bear|grizzly bears
groundhog|groundhogs
guinea pig|guinea pigs
gull|gulls
hamster|hamsters
hare|hares
hatchet fish|hatchet fish
hawk|hawks
hedgehog|hedgehogs
hen|hens
heron|herons
hippopotamus|hippopotamus
honey bee|honey bees
horse|horses
hound|hounds
house fly|house flies
human|humans
human|humans
human|humans
human|humans
human|humans
hummingbird|hummingbirds
husky|huskies
hyena|hyenas
iguana|iguanas
iguanodon|iguanodons
impala|impalas
insect|insects
jaguar|jaguars
jay|jays
jellyfish|jellyfish
kangaroo|kangaroos
kiwi|kiwis
koala|koalas
komodo dragon|komodo dragons
kookaburra|kookaburras
ladybug|ladybugs
lantern fish|lantern fish
lemming|lemmings
lemur|lemurs
leopard|leopards
lion|lions
lizard|lizards
llama|llamas
lobster|lobsters
lynx|lynxes
macaw|macaws
mallard|mallards
mammoth|mammoths
man|men
man|men
man|men
man|men
man|men
mandrill|mandrills
manta ray|manta rays
meadowlark|meadowlarks
monkey|monkeys
moth|moths
newt|newts
nightingale|nightingales
ocelot|ocelots
octopus|octopi
otter|otters
owl|owls
oyster|oysters
panda|pandas
pangolin|pangolins
panther|panthers
parrot|parrots
penguin|penguins
person|people
person|people
person|people
person|people
person|people
pill bug|pill bugs
piranha|piranhas
plankton|plankton
porcupine|porcupines
porpoise|porpoises
python|pythons
quail|quail
quetzal|quetzals
rabbit|rabbits
raccoon|raccoons
rat|rats
rattlesnake|rattlesnakes
reindeer|reindeer
rhinoceros|rhinoceroses
roadrunner|roadrunners
robin|robins
rooster|roosters
salamander|salamanders
salmon|salmons
scallop|scallops
scorpion|scorpions
seagull|seagulls
seal|seals
shark|sharks
sheep|sheep
sloth|sloths
squid|squids
squirrel|squirrels
tamarin|tamarins
tapir|tapirs
tarantula|tarantulas
terrier|terriers
tiger|tigers
tortoise|tortoises
toucan|toucans
trout|trout
turtle|turtles
unicorn|unicorns
urchin|urchins
vulture|vultures
walking stick|walking sticks
wallaby|wallabies
walrus|walruses
wasp|wasps
weasel|weasels
whale|whales
wildebeest|wildebeests
wolf|wolves
wolverine|wolverines
wombat|wombats
woman|women
woman|women
woman|women
woman|women
woman|women
woodchuck|woodchucks
woodpecker|woodpeckers
woolly mammoth|woolly mammoths
worm|worms
yellow jacket|yellow jackets
zebra|zebras
